1011101111
1011101011
1011101101
1101111111
1111101111
1111101111
1111001111
1110101111
1111101111
1111101111